NO ./wall_0.xpm
SO ./wall_1.xpm
WE ./wall_2.xpm
EA ./wall_3.xpm
F 120,100,0
C 25,30,50
1111111111111111111111111
1000000000110000000000001
1011000001110000000000001
100100000000000000000000111111111
111111111011000001110000000000001
100000000011000001110111111111111
11110111111111011100000010001
11110111111111011101010010001
11000000110101011100000010001
100000W0000000001100000010001
10000000000000001101010010001
1100000111010101111101111000111
11110111 1110101 101111010001
11111111 1111111 111111111111
